MLS ID,OJO Source Name ,MLS Name,Listings Requests,New Listings Requests,Updated Listings Requests,Happy Cases,Happy Cases (%),Not Found Cases,Not Found Cases (%),First Found - New,Recovery Cases - New,New Listings Recovered,New Listings Not Recovered,First Found - Updates,Recovery Cases - Updates,Updated Listings Recovered,Update Listings Not Recovered,Min - RT,Listings Recovery <= Avg Time,Avg - RT,Listings recovered > Avg Time,Max - RT,Min - RT - New,New Listings Recovery <= Avg Time,Avg - RT - New,New Listings recovered > Avg Time,Max - RT - New,Min - RT - Updates,Updated Listings Recovery <= Avg Time,Avg - RT - Updates,Updated Listings recovered > Avg Time,Max - RT - Updates,Report - Start Time,Report - End Time
12,ca_bear,MAXEBRDI,570,199,374,553,97.02,17,2.980000000000004,5,194,178,16,374,0,0,0,0:15:01.680000,96,1:24:12.598232,85,13:25:01.140000,0:15:01.680000,95,1:24:09.948989,83,13:25:01.140000,None,0,None,0,None,2022-03-31 00:00:34,2022-04-01 00:00:34
100,ca_mlslistings,MLSListings,570,183,389,551,96.67,19,3.3299999999999983,7,176,157,19,389,0,0,0,0:10:00.450000,82,1:08:18.596296,80,2:18:32.180000,0:10:00.450000,78,1:09:32.354140,79,2:18:32.180000,None,0,None,0,None,2022-03-31 00:00:34,2022-04-01 00:00:34
101,ca_bareis,BAREIS,181,88,96,179,98.9,2,1.0999999999999943,33,55,54,1,96,0,0,0,0:10:00.520000,21,0:53:27.062679,35,1:44:28.860000,0:10:00.520000,21,0:52:40.307963,33,1:44:28.860000,None,0,None,0,None,2022-03-31 00:00:34,2022-04-01 00:00:34
102,ca_metrolist,Metrolist,717,405,317,714,99.58,3,0.4200000000000017,14,391,388,3,317,0,0,0,0:09:37.430000,213,3:26:17.423909,181,11:35:02.310000,0:09:37.430000,208,3:23:53.662655,180,11:35:02.310000,None,0,None,0,None,2022-03-31 00:00:34,2022-04-01 00:00:34
104,ca_fmls,Fresno MLS,154,82,72,126,81.82,28,18.180000000000007,0,82,56,26,72,0,0,0,0:15:01.680000,33,1:55:19.348103,25,3:51:34.240000,0:15:01.680000,32,1:53:51.031429,24,3:51:34.240000,None,0,None,0,None,2022-03-31 00:00:34,2022-04-01 00:00:34
110,ca_sfar,SFARMLS,132,82,50,120,90.91,12,9.090000000000003,2,80,68,12,50,0,0,0,0:15:01.370000,40,1:04:30.505652,29,2:24:29.160000,0:15:01.370000,40,1:03:46.407794,28,2:24:29.160000,None,0,None,0,None,2022-03-31 00:00:34,2022-04-01 00:00:34
202,ca_mrmls,CRMLS,2382,1158,1224,2088,87.66,294,12.340000000000003,15,1143,863,280,1206,18,16,2,0:15:02.260000,560,2:46:41.188024,341,15:45:02.030000,0:15:02.260000,537,2:46:33.604079,326,15:45:02.030000,0:22:47.810000,7,2:16:32.218125,9,8:22:37.180000,2022-03-31 00:00:34,2022-04-01 00:00:34
203,ca_claw,The MLS,280,122,162,279,99.64,1,0.35999999999999943,14,108,108,0,162,0,0,0,0:08:25.350000,48,0:29:08.700364,62,0:58:30.140000,0:08:25.350000,47,0:29:09.462130,61,0:58:30.140000,None,0,None,0,None,2022-03-31 00:00:34,2022-04-01 00:00:34
206,ca_damls,Desert Area MLS,112,57,55,112,100.0,0,0.0,13,44,44,0,55,0,0,0,0:14:59.880000,41,0:25:14.732667,4,1:48:26.250000,0:14:59.880000,40,0:25:21.851818,4,1:48:26.250000,None,0,None,0,None,2022-03-31 00:00:34,2022-04-01 00:00:34
207,ca_mrmls,VCRDS,44,26,18,36,81.82,8,18.180000000000007,0,26,20,6,18,0,0,0,0:48:28.470000,11,3:11:28.644000,9,6:48:25.680000,0:48:28.470000,11,3:11:28.644000,9,6:48:25.680000,None,0,None,0,None,2022-03-31 00:00:34,2022-04-01 00:00:34
208,ca_sbaor,Santa Barbara AOR,18,6,12,18,100.0,0,0.0,6,0,0,0,12,0,0,0,None,0,None,0,None,None,0,None,0,None,None,0,None,0,None,2022-03-31 00:00:34,2022-04-01 00:00:34
210,ca_sdmls,San Diego MLS,379,117,264,350,92.35,29,7.650000000000006,8,109,82,27,264,0,0,0,0:19:34.600000,39,2:26:35.873494,44,5:15:05.590000,0:19:34.600000,38,2:26:44.293171,44,5:15:05.590000,None,0,None,0,None,2022-03-31 00:00:34,2022-04-01 00:00:34
211,ca_vvmls,High Desert MLS,0,0,0,0,0,0,0,0,0,0,0,0,0,0,0,None,0,None,0,None,None,0,None,0,None,None,0,None,0,None,2022-03-31 00:00:34,2022-04-01 00:00:34
212,ca_baor,GEMLS,70,45,25,68,97.14,2,2.8599999999999994,25,20,18,2,25,0,0,0,1:00:00.700000,6,1:29:21.130000,14,2:32:27.480000,1:00:00.700000,5,1:30:07.179444,13,2:32:27.480000,None,0,None,0,None,2022-03-31 00:00:34,2022-04-01 00:00:34
213,ca_tsbor,Tahoe Sierra MLS,32,20,12,32,100.0,0,0.0,16,4,4,0,12,0,0,0,0:15:00.810000,3,0:35:38.175000,1,1:37:29.060000,0:15:00.810000,3,0:35:38.175000,1,1:37:29.060000,None,0,None,0,None,2022-03-31 00:00:34,2022-04-01 00:00:34
214,ca_tcmls,Tulare MLS,56,25,31,56,100.0,0,0.0,13,12,12,0,31,0,0,0,0:10:03.160000,7,0:48:37.525385,6,1:22:27.520000,0:10:03.160000,6,0:50:10.622500,6,1:22:27.520000,None,0,None,0,None,2022-03-31 00:00:34,2022-04-01 00:00:34
300,ma_mlspin,MLS PIN,1193,623,576,723,60.6,470,39.4,16,607,170,437,561,15,2,13,0:40:21.430000,102,5:05:09.299829,73,18:00:00.700000,0:40:21.430000,98,5:08:12.098471,72,18:00:00.700000,1:50:36.980000,1,4:15:32.675000,1,6:40:28.370000,2022-03-31 00:00:34,2022-04-01 00:00:34
301,ma_cciaor,CCIMLS,50,30,20,50,100.0,0,0.0,2,28,28,0,20,0,0,0,0:54:28.360000,19,1:26:06.127143,9,3:09:28.560000,0:54:28.360000,19,1:26:06.127143,9,3:09:28.560000,None,0,None,0,None,2022-03-31 00:00:34,2022-04-01 00:00:34
302,ma_bcmls,Berkshire Realtor MLS,33,17,16,32,96.97,1,3.030000000000001,10,7,6,1,16,0,0,0,0:54:26.510000,3,0:54:28.916667,3,0:54:31.070000,0:54:26.510000,3,0:54:28.916667,3,0:54:31.070000,None,0,None,0,None,2022-03-31 00:00:34,2022-04-01 00:00:34
310,bright_mls,Bright MLS,3740,2162,1583,3145,84.09,595,15.909999999999997,3,2159,1616,543,1557,26,18,8,0:10:26.830000,548,6:17:10.526714,1156,15:35:30.640000,0:10:26.830000,497,6:20:28.308657,1119,15:35:30.640000,1:20:31.260000,9,4:55:06.768333,9,8:30:36.680000,2022-03-31 00:00:34,2022-04-01 00:00:34
311,va_rein,REIN,431,222,209,9,2.09,422,97.91,0,222,0,222,102,107,0,107,None,0,None,0,None,None,0,None,0,None,None,0,None,0,None,2022-03-31 00:00:34,2022-04-01 00:00:34
312,va_cvrmls,Virginia MLS Cooperative,242,155,87,221,91.32,21,8.680000000000007,20,135,126,9,83,4,0,4,0:14:26.070000,50,1:11:37.229612,79,6:49:31.940000,0:14:26.070000,49,1:11:37.862460,77,6:49:31.940000,None,0,None,0,None,2022-03-31 00:00:34,2022-04-01 00:00:34
313,va_caar,CAAR - Charlottesville Area Association of Realtors,202,116,86,199,98.51,3,1.4899999999999949,12,104,101,3,86,0,0,0,0:20:00.380000,62,1:33:47.783113,44,2:53:29.650000,0:20:00.380000,58,1:34:24.420594,43,2:53:29.650000,None,0,None,0,None,2022-03-31 00:00:34,2022-04-01 00:00:34
314,va_rvar,Roanoke Valley AOR,57,27,30,57,100.0,0,0.0,10,17,17,0,30,0,0,0,0:13:25.440000,11,0:28:44.280588,6,1:13:25.990000,0:13:25.440000,11,0:28:44.280588,6,1:13:25.990000,None,0,None,0,None,2022-03-31 00:00:34,2022-04-01 00:00:34
321,nv_glvar,GLVAR,473,204,270,453,95.77,20,4.230000000000004,6,198,178,20,270,0,0,0,0:05:01.010000,117,1:17:23.897098,76,3:19:28.930000,0:05:01.010000,110,1:17:03.982303,68,3:19:28.930000,None,0,None,0,None,2022-03-31 00:00:34,2022-04-01 00:00:34
322,nv_nnrmls,NNRMLS,186,82,104,182,97.85,4,2.1500000000000057,9,73,69,4,104,0,0,0,0:25:03.170000,33,1:34:12.161884,36,2:24:29.870000,0:25:03.170000,33,1:34:12.161884,36,2:24:29.870000,None,0,None,0,None,2022-03-31 00:00:34,2022-04-01 00:00:34
400,tx_gepar,GEPAR,66,33,33,65,98.48,1,1.519999999999996,3,30,29,1,33,0,0,0,0:06:30.560000,14,1:10:38.002414,15,1:51:30.690000,0:06:30.560000,14,1:10:38.002414,15,1:51:30.690000,None,0,None,0,None,2022-03-31 00:00:34,2022-04-01 00:00:34
401,tx_sabor,SABOR MLS,623,235,392,620,99.52,3,0.480000000000004,32,203,200,3,392,0,0,0,0:05:00.890000,101,1:07:03.170580,106,1:57:28.240000,0:05:00.890000,95,1:07:03.757100,105,1:57:28.240000,None,0,None,0,None,2022-03-31 00:00:34,2022-04-01 00:00:34
402,tx_ntreis,NTREIS,1790,917,876,823,45.98,967,54.02,0,917,0,917,873,3,0,3,None,0,None,0,None,None,0,None,0,None,None,0,None,0,None,2022-03-31 00:00:34,2022-04-01 00:00:34
403,tx_har,HARMLS,1893,723,1183,1861,98.31,32,1.6899999999999977,0,723,699,24,1179,4,4,0,0:04:59.330000,345,1:21:24.435129,392,2:53:30.100000,0:04:59.330000,323,1:21:33.945651,376,2:53:30.100000,1:00:00.610000,3,1:43:01.312500,1,2:38:30.560000,2022-03-31 00:00:34,2022-04-01 00:00:34
404,tx_actris,ACTRIS,648,416,232,602,92.9,46,7.099999999999994,0,416,370,46,232,0,0,0,0:30:00.890000,220,2:23:55.492812,157,5:36:30.700000,0:30:00.890000,216,2:24:03.801730,154,5:36:30.700000,None,0,None,0,None,2022-03-31 00:00:34,2022-04-01 00:00:34
405,tx_ctxmls,CTXMLS,175,100,75,171,97.71,4,2.2900000000000063,0,100,96,4,75,0,0,0,0:41:31.830000,48,1:45:12.642727,51,3:26:30.320000,0:41:31.830000,45,1:45:57.020938,51,3:26:30.320000,None,0,None,0,None,2022-03-31 00:00:34,2022-04-01 00:00:34
406,tx_gtar,Greater Tyler AOR,139,40,99,135,97.12,4,2.8799999999999955,11,29,25,4,98,1,1,0,0:40:29.040000,15,1:50:57.104615,11,3:25:25.970000,0:40:29.040000,15,1:49:34.291600,10,3:25:25.970000,2:25:27.430000,1,2:25:27.430000,0,2:25:27.430000,2022-03-31 00:00:34,2022-04-01 00:00:34
407,tx_laar,Longview MLS,38,20,18,37,97.37,1,2.6299999999999955,12,8,7,1,18,0,0,0,1:25:23.510000,5,1:51:07.700000,2,3:25:23.230000,1:25:23.510000,5,1:51:07.700000,2,3:25:23.230000,None,0,None,0,None,2022-03-31 00:00:34,2022-04-01 00:00:34
409,tx_gmar,Greater McAllen AOR,102,44,58,102,100.0,0,0.0,3,41,41,0,58,0,0,0,0:05:00.890000,21,0:43:39.308571,21,1:06:32.590000,0:05:00.890000,21,0:43:13.223415,20,1:06:32.590000,None,0,None,0,None,2022-03-31 00:00:34,2022-04-01 00:00:34
410,tx_ccar,Corpus Christi AOR,94,42,53,62,65.96,32,34.040000000000006,0,42,15,27,52,1,0,1,1:24:29.950000,8,3:43:33.489375,8,7:19:29.900000,1:24:29.950000,7,3:51:49.832000,8,7:19:29.900000,None,0,None,0,None,2022-03-31 00:00:34,2022-04-01 00:00:34
411,ncsc_cmls,Carolina MLS,900,369,539,685,76.11,215,23.89,0,369,209,160,481,58,21,37,0:53:26.950000,215,2:01:29.691516,29,17:00:00.770000,0:53:26.950000,183,2:03:38.905694,26,17:00:00.770000,0:53:33.640000,20,1:56:20.458571,1,3:53:29.440000,2022-03-31 00:00:34,2022-04-01 00:00:34
412,nc_triad,TRIAD MLS,288,142,147,239,82.99,49,17.010000000000005,12,130,88,42,128,19,12,7,0:15:01.130000,52,1:17:05.941875,60,4:48:27.150000,0:15:01.130000,42,1:13:07.760455,46,2:23:29.680000,1:38:27.140000,11,1:54:17.710833,1,4:48:27.150000,2022-03-31 00:00:34,2022-04-01 00:00:34
413,nc_tmls,Triangle MLS,553,228,327,542,98.01,11,1.9899999999999949,0,228,218,10,327,0,0,0,0:38:28.450000,125,1:43:20.374635,108,2:23:31.700000,0:38:28.450000,118,1:43:14.170642,100,2:23:31.700000,None,0,None,0,None,2022-03-31 00:00:34,2022-04-01 00:00:34
415,nc_ccar,WRAR,416,225,193,412,99.04,4,0.9599999999999937,44,181,178,3,193,0,0,0,0:25:00.700000,114,1:13:42.679219,78,2:14:29.480000,0:25:00.700000,104,1:14:14.279775,74,2:14:29.480000,None,0,None,0,None,2022-03-31 00:00:34,2022-04-01 00:00:34
416,nc_frar,"Longleaf Pine REALTORS, Inc.",88,64,24,87,98.86,1,1.1400000000000006,0,64,63,1,24,0,0,0,0:40:00.090000,38,1:31:53.580147,30,2:13:33.090000,0:40:00.090000,36,1:32:05.128413,27,2:13:33.090000,None,0,None,0,None,2022-03-31 00:00:34,2022-04-01 00:00:34
417,nc_hcar,High Country AOR,54,22,32,54,100.0,0,0.0,0,22,22,0,31,1,1,0,0:27:25.050000,10,1:07:15.532000,15,1:47:26.420000,0:27:25.050000,9,1:06:46.666364,13,1:47:26.420000,1:17:27.520000,1,1:17:27.520000,0,1:17:27.520000,2022-03-31 00:00:34,2022-04-01 00:00:34
418,nc_pspaar,Mid Carolina MLS,0,0,0,0,0,0,0,0,0,0,0,0,0,0,0,None,0,None,0,None,None,0,None,0,None,None,0,None,0,None,2022-03-31 00:00:34,2022-04-01 00:00:34
419,nc_baar,Burlington Almanace MLS,27,18,9,27,100.0,0,0.0,0,18,18,0,9,0,0,0,1:11:29.580000,11,1:34:28.791500,9,2:06:29.660000,1:11:29.580000,9,1:35:55.573333,9,2:06:29.660000,None,0,None,0,None,2022-03-31 00:00:34,2022-04-01 00:00:34
420,tx_war,Waco MLS,59,43,16,58,98.31,1,1.6899999999999977,4,39,38,1,16,0,0,0,0:15:02.200000,17,1:26:29.679487,22,2:04:27.680000,0:15:02.200000,16,1:27:58.893158,22,2:04:27.680000,None,0,None,0,None,2022-03-31 00:00:34,2022-04-01 00:00:34
421,ga_mls,Georgia MLS,1861,829,1039,1803,96.88,58,3.1200000000000045,1,828,791,37,1032,7,2,5,0:25:00.710000,467,1:35:19.204890,351,2:54:31.910000,0:25:01.060000,451,1:35:50.153262,340,2:54:31.910000,0:54:34.350000,1,1:19:33.345000,1,1:44:32.340000,2022-03-31 00:00:34,2022-04-01 00:00:34
422,ga_fmls,FMLS,1637,693,947,1603,97.92,34,2.0799999999999983,0,693,660,33,946,1,1,0,0:35:01.520000,341,1:46:41.998580,335,4:56:31.160000,0:35:01.520000,333,1:46:43.566394,327,4:56:31.160000,1:51:29.150000,1,1:51:29.150000,0,1:51:29.150000,2022-03-31 00:00:34,2022-04-01 00:00:34
423,ga_negbor,Northeast Georgia Board of Realtors,180,52,128,164,91.11,16,8.89,40,12,0,12,125,3,0,3,19:29:59.250000,1,19:29:59.250000,0,19:29:59.250000,None,0,None,0,None,None,0,None,0,None,2022-03-31 00:00:34,2022-04-01 00:00:34
424,fl_tbr,Tallahassee MLS,110,53,59,105,95.45,5,4.549999999999997,2,51,50,1,59,0,0,0,0:10:01.220000,29,0:37:37.774444,25,1:07:28.080000,0:10:01.220000,26,0:37:41.284600,24,1:07:28.080000,None,0,None,0,None,2022-03-31 00:00:34,2022-04-01 00:00:34
425,fl_dbaar,DBAAR,70,30,40,70,100.0,0,0.0,4,26,26,0,40,0,0,0,0:04:59.980000,16,0:53:25.183333,11,1:32:28.270000,0:04:59.980000,16,0:52:52.730769,10,1:32:28.270000,None,0,None,0,None,2022-03-31 00:00:34,2022-04-01 00:00:34
426,fl_pmls,Pensacola Association of Realtors - PAR,110,55,55,106,96.36,4,3.6400000000000006,5,50,46,4,55,0,0,0,0:12:30.530000,27,0:49:25.365000,19,3:27:28.380000,0:12:30.530000,27,0:49:25.365000,19,3:27:28.380000,None,0,None,0,None,2022-03-31 00:00:34,2022-04-01 00:00:34
428,fl_rafgc,RAFGC MLS,23,9,15,23,100.0,0,0.0,1,8,8,0,15,0,0,0,0:04:59.820000,5,2:00:56.082500,3,3:56:29.100000,0:04:59.820000,5,2:00:56.082500,3,3:56:29.100000,None,0,None,0,None,2022-03-31 00:00:34,2022-04-01 00:00:34
429,mi_bcra,Bay County MLS,0,0,0,0,0,0,0,0,0,0,0,0,0,0,0,None,0,None,0,None,None,0,None,0,None,None,0,None,0,None,2022-03-31 00:00:34,2022-04-01 00:00:34
430,fl_ecar,Emerald Coast MLS,174,75,99,164,94.25,10,5.75,1,74,64,10,99,0,0,0,0:56:33.440000,34,2:53:19.279589,39,4:56:34.500000,0:56:33.440000,31,2:56:32.288437,33,4:56:34.500000,None,0,None,0,None,2022-03-31 00:00:34,2022-04-01 00:00:34
431,fl_mfrmls,Stellar MLS,2253,1078,1202,2032,90.19,221,9.810000000000002,0,1078,868,210,1202,0,0,0,0:59:57.170000,524,2:25:05.268684,380,6:06:34.120000,0:59:57.170000,500,2:25:32.228364,368,6:06:34.120000,None,0,None,0,None,2022-03-31 00:00:34,2022-04-01 00:00:34
432,fl_ramb,SEFMLS,1962,286,1677,1954,99.59,8,0.4099999999999966,46,240,232,8,1677,0,0,0,0:05:00.630000,112,1:00:04.363362,123,9:43:28.840000,0:05:00.630000,111,1:00:14.230345,121,9:43:28.840000,None,0,None,0,None,2022-03-31 00:00:34,2022-04-01 00:00:34
433,fl_nefmls,NEFAR MLS,388,200,190,383,98.71,5,1.2900000000000063,57,143,138,5,188,2,2,0,0:03:27.830000,73,0:34:23.009103,72,1:08:27.770000,0:03:27.830000,70,0:34:41.788478,68,1:08:27.770000,0:10:01.370000,1,0:11:45.245000,1,0:13:29.120000,2022-03-31 00:00:34,2022-04-01 00:00:34
434,fl_space,Space Coast MLS,261,71,190,229,87.74,32,12.260000000000005,46,25,9,16,171,19,3,16,0:04:30.260000,11,2:13:29.980000,3,7:55:01.110000,0:04:30.260000,7,2:22:19.991111,2,7:55:01.110000,0:59:30.660000,2,2:36:21.493333,1,5:50:03.100000,2022-03-31 00:00:34,2022-04-01 00:00:34
435,fl_rmls,Beaches MLS,515,191,327,441,85.63,74,14.370000000000005,3,188,124,64,289,38,29,9,0:20:01.030000,104,1:52:00.654534,57,10:30:00.230000,0:20:01.030000,73,1:45:05.532984,51,6:12:32.270000,1:22:31.200000,26,2:07:34.510690,3,6:02:32.330000,2022-03-31 00:00:34,2022-04-01 00:00:34
436,fl_ragfl,GFLR MLS,390,96,295,355,91.03,35,8.969999999999999,2,94,64,30,285,10,7,3,0:15:00.640000,59,1:56:08.608800,16,20:20:03.380000,0:15:00.640000,52,2:00:14.924219,12,20:20:03.380000,1:17:28.780000,5,1:35:20.478571,2,1:57:29.130000,2022-03-31 00:00:34,2022-04-01 00:00:34
437,fl_fkbor,FKBOR MLS,56,16,40,53,94.64,3,5.359999999999999,0,16,13,3,40,0,0,0,1:12:31.560000,6,3:27:30.089231,7,4:37:31.310000,1:12:31.560000,6,3:27:30.089231,7,4:37:31.310000,None,0,None,0,None,2022-03-31 00:00:34,2022-04-01 00:00:34
438,fl_gfmb,Florida Gulf Coast MLS,381,166,216,374,98.16,7,1.8400000000000034,3,163,157,6,216,0,0,0,0:05:00.650000,67,0:49:06.750250,93,1:52:25.520000,0:05:00.650000,67,0:48:39.949936,90,1:52:25.520000,None,0,None,0,None,2022-03-31 00:00:34,2022-04-01 00:00:34
439,fl_mlsn,MLS of Naples,273,83,191,271,99.27,2,0.730000000000004,3,80,78,2,191,0,0,0,0:05:00.110000,48,1:07:35.303418,31,1:47:28.890000,0:05:00.110000,34,1:07:23.861538,44,1:47:28.890000,None,0,None,0,None,2022-03-31 00:00:34,2022-04-01 00:00:34
440,fl_rairc,RAIRC MLS,51,26,25,51,100.0,0,0.0,10,16,16,0,25,0,0,0,0:25:24.470000,12,2:28:52.495556,6,8:25:25.440000,0:25:24.470000,10,2:42:08.761875,6,8:25:25.440000,None,0,None,0,None,2022-03-31 00:00:34,2022-04-01 00:00:34
442,pa_wpn,West Penn Multi-List,340,204,140,333,97.94,7,2.0600000000000023,29,175,168,7,140,0,0,0,0:30:00.490000,114,1:43:19.159353,56,3:42:29.600000,0:30:00.490000,113,1:43:28.692798,55,3:42:29.600000,None,0,None,0,None,2022-03-31 00:00:34,2022-04-01 00:00:34
443,pa_lvar,GLVR,177,56,122,157,88.7,20,11.299999999999997,0,56,41,15,116,6,2,4,0:15:05.130000,22,2:25:45.734651,21,5:50:00.670000,0:15:05.130000,22,2:20:10.743171,19,4:50:33.220000,2:50:25.450000,1,4:20:13.060000,1,5:50:00.670000,2022-03-31 00:00:34,2022-04-01 00:00:34
444,fl_gacar,Gainsville Alchua County AOR,0,0,0,0,0,0,0,0,0,0,0,0,0,0,0,None,0,None,0,None,None,0,None,0,None,None,0,None,0,None,2022-03-31 00:00:34,2022-04-01 00:00:34
445,fl_hcar,Hernando County AOR,52,25,28,50,96.15,2,3.8499999999999943,3,22,20,2,28,0,0,0,0:13:23.960000,11,0:45:27.338500,9,2:08:26.400000,0:13:23.960000,11,0:45:27.338500,9,2:08:26.400000,None,0,None,0,None,2022-03-31 00:00:34,2022-04-01 00:00:34
446,fl_sasjcbr,St Augustine St Johns MLS,59,29,30,38,64.41,21,35.59,0,29,9,20,30,0,0,0,0:35:27.680000,5,6:08:20.344000,5,15:40:26.820000,0:35:27.680000,5,6:39:15.117778,4,15:40:26.820000,None,0,None,0,None,2022-03-31 00:00:34,2022-04-01 00:00:34
447,fl_fcar,Flagler County MLS,64,22,42,64,100.0,0,0.0,0,22,22,0,42,0,0,0,0:05:00.910000,11,0:51:50.527826,12,1:50:00.200000,0:05:00.910000,11,0:51:28.149545,11,1:50:00.200000,None,0,None,0,None,2022-03-31 00:00:34,2022-04-01 00:00:34
448,fl_nsb,New Smyrna Beach MLS,21,11,10,21,100.0,0,0.0,0,11,11,0,10,0,0,0,0:04:37.450000,6,1:30:21.107500,10,2:25:25.020000,0:04:37.450000,4,1:33:30.044545,7,2:25:25.020000,None,0,None,0,None,2022-03-31 00:00:34,2022-04-01 00:00:34
449,fl_ramc,MCRTC,38,6,32,37,97.37,1,2.6299999999999955,0,6,5,1,32,0,0,0,1:15:01.380000,3,1:43:07.636000,2,2:30:06.380000,1:15:01.380000,3,1:43:07.636000,2,2:30:06.380000,None,0,None,0,None,2022-03-31 00:00:34,2022-04-01 00:00:34
450,pa_gebr,Greater Erie BOR,32,21,12,31,96.88,1,3.1200000000000045,1,20,19,1,12,0,0,0,0:30:01.390000,10,2:18:44.319474,9,3:55:27.540000,0:30:01.390000,10,2:18:44.319474,9,3:55:27.540000,None,0,None,0,None,2022-03-31 00:00:34,2022-04-01 00:00:34
451,nj_gsmls,GSMLX,613,246,375,503,82.06,110,17.939999999999998,0,246,150,96,352,23,10,13,0:59:31.200000,97,1:31:48.633727,64,7:44:34.090000,0:59:31.200000,96,1:31:00.915800,54,7:44:34.090000,1:44:27.660000,5,1:44:28.063000,5,1:44:29.140000,2022-03-31 00:00:34,2022-04-01 00:00:34
452,nj_momls,Monmouth/Ocean MLS,354,147,210,302,85.31,52,14.689999999999998,15,132,91,41,190,20,10,10,0:44:32.910000,71,1:52:57.688039,31,6:19:29.830000,0:44:32.910000,62,1:50:41.345714,29,3:34:29.680000,1:14:28.530000,8,2:13:58.824000,2,6:19:29.830000,2022-03-31 00:00:34,2022-04-01 00:00:34
453,nj_sjsrmls,SJSR MLS,84,29,55,84,100.0,0,0.0,0,29,29,0,55,0,0,0,0:15:01.330000,15,1:09:16.213226,16,1:41:32.260000,0:15:01.330000,14,1:08:56.576552,15,1:41:32.260000,None,0,None,0,None,2022-03-31 00:00:34,2022-04-01 00:00:34
454,nj_mls,New Jersey MLS,326,131,196,318,97.55,8,2.450000000000003,4,127,119,8,196,0,0,0,0:04:59.470000,55,0:51:39.447983,64,1:27:28.650000,0:04:59.470000,55,0:51:39.447983,64,1:27:28.650000,None,0,None,0,None,2022-03-31 00:00:34,2022-04-01 00:00:34
455,nj_cmcar,Cape May County MLS,51,17,35,49,96.08,2,3.9200000000000017,0,17,17,0,35,0,0,0,1:27:30.150000,7,1:50:43.144706,10,2:12:29.150000,1:27:30.150000,7,1:50:43.144706,10,2:12:29.150000,None,0,None,0,None,2022-03-31 00:00:34,2022-04-01 00:00:34
456,nj_mcmls,Central Jersey MLS - CJMLS,165,44,130,137,83.03,28,16.97,0,44,21,23,122,8,3,5,0:40:02.470000,14,1:26:08.395833,10,1:57:27.540000,0:40:02.470000,8,1:22:23.181429,13,1:57:27.540000,1:52:24.830000,1,1:52:24.896667,2,1:52:24.940000,2022-03-31 00:00:34,2022-04-01 00:00:34
457,nj_hcmls,Hudson County MLS,134,62,73,131,97.76,3,2.239999999999995,2,60,57,3,73,0,0,0,0:20:01.700000,39,1:42:56.140175,18,3:56:30.970000,0:20:01.700000,39,1:42:56.140175,18,3:56:30.970000,None,0,None,0,None,2022-03-31 00:00:34,2022-04-01 00:00:34
461,il_mred,MRED,2067,903,1173,1912,92.5,155,7.5,0,903,754,149,1173,0,0,0,0:44:35.490000,334,2:00:14.511995,443,20:00:00.900000,0:54:59.920000,314,2:01:06.182599,440,20:00:00.900000,None,0,None,0,None,2022-03-31 00:00:34,2022-04-01 00:00:34
462,ga_sabor,Savannah Board of Realtors,108,68,42,104,96.3,4,3.700000000000003,0,68,64,4,42,0,0,0,0:50:01.880000,39,1:53:54.776970,27,3:24:30.800000,0:50:01.880000,39,1:52:43.379219,25,3:24:30.800000,None,0,None,0,None,2022-03-31 00:00:34,2022-04-01 00:00:34
463,ga_gaar,GAAR,0,0,0,0,0,0,0,0,0,0,0,0,0,0,0,None,0,None,0,None,None,0,None,0,None,None,0,None,0,None,2022-03-31 00:00:34,2022-04-01 00:00:34
464,ga_cgmls,Central Georgia MLS,45,20,25,44,97.78,1,2.219999999999999,0,20,20,0,24,1,0,1,0:54:28.280000,11,1:19:30.274500,9,1:49:30.160000,0:54:28.280000,11,1:19:30.274500,9,1:49:30.160000,None,0,None,0,None,2022-03-31 00:00:34,2022-04-01 00:00:34
466,ga_giar,Golden Isle MLS,36,19,17,36,100.0,0,0.0,0,19,19,0,17,0,0,0,0:45:03.160000,8,1:43:50.333500,12,2:29:28.710000,0:45:03.160000,8,1:42:29.407895,11,2:29:28.710000,None,0,None,0,None,2022-03-31 00:00:34,2022-04-01 00:00:34
471,az_mls,ARMLS,1177,581,601,1021,86.75,156,13.25,20,561,415,146,601,0,0,0,0:05:21.760000,305,1:12:25.371238,123,5:15:12.680000,0:05:21.760000,297,1:12:33.917470,118,5:15:12.680000,None,0,None,0,None,2022-03-31 00:00:34,2022-04-01 00:00:34
472,az_tar,TARMLS,229,97,135,189,82.53,40,17.47,4,93,58,35,135,0,0,0,0:04:28.740000,37,1:15:53.400806,25,3:09:33.160000,0:04:28.740000,33,1:17:32.325862,25,3:09:33.160000,None,0,None,0,None,2022-03-31 00:00:34,2022-04-01 00:00:34
473,az_naar,Northern Arizona AOR,23,17,6,21,91.3,2,8.700000000000003,2,15,13,2,6,0,0,0,1:00:01.220000,8,1:15:00.060714,6,1:28:29.290000,1:00:01.220000,7,1:15:07.198462,6,1:28:29.290000,None,0,None,0,None,2022-03-31 00:00:34,2022-04-01 00:00:34
474,az_wardex,Arizona MLS WARDEX,62,29,35,62,100.0,0,0.0,3,26,26,0,35,0,0,0,0:10:01.940000,14,0:35:37.030370,13,1:01:28.940000,0:10:01.940000,13,0:35:49.972692,13,1:01:28.940000,None,0,None,0,None,2022-03-31 00:00:34,2022-04-01 00:00:34
475,az_wmar,White Mountain MLS,49,27,23,48,97.96,1,2.0400000000000063,1,26,25,1,23,0,0,0,1:11:31.470000,18,2:06:17.872400,7,4:01:30.190000,1:11:31.470000,18,2:06:17.872400,7,4:01:30.190000,None,0,None,0,None,2022-03-31 00:00:34,2022-04-01 00:00:34
476,az_paar,Prescott Area AOR,67,32,36,62,92.54,5,7.459999999999994,0,32,27,5,36,0,0,0,0:05:02.320000,12,1:28:51.587778,15,2:48:26.160000,0:05:02.320000,12,1:28:51.587778,15,2:48:26.160000,None,0,None,0,None,2022-03-31 00:00:34,2022-04-01 00:00:34
482,ny_ghvmls,OneKey MLS,1352,494,866,528,39.05,824,60.95,0,494,8,486,666,200,0,200,1:31:36.200000,4,2:03:16.025000,4,3:01:34.030000,1:31:36.200000,4,2:03:16.025000,4,3:01:34.030000,None,0,None,0,None,2022-03-31 00:00:34,2022-04-01 00:00:34
483,ny_mhmls,Mid-Hudson MLS,58,19,46,42,72.41,16,27.590000000000003,0,19,3,16,46,0,0,0,0:30:02.650000,1,0:50:01.986667,2,1:00:01.660000,0:30:02.650000,1,0:50:01.986667,2,1:00:01.660000,None,0,None,0,None,2022-03-31 00:00:34,2022-04-01 00:00:34
484,ny_rebny_idx,REBNY,2684,185,2510,1666,62.07,1018,37.93,2,183,0,183,1892,618,0,618,None,0,None,0,None,None,0,None,0,None,None,0,None,0,None,2022-03-31 00:00:34,2022-04-01 00:00:34
485,ny_gcar,Global MLS,159,87,74,155,97.48,4,2.519999999999996,0,87,83,4,74,0,0,0,0:55:01.520000,44,1:57:21.424111,46,2:26:35.050000,0:55:01.520000,41,1:57:29.262651,42,2:26:35.050000,None,0,None,0,None,2022-03-31 00:00:34,2022-04-01 00:00:34
486,ny_wnyreis,WNYREIS,376,187,192,369,98.14,7,1.8599999999999994,6,181,174,7,192,0,0,0,0:05:00.630000,97,1:52:10.745278,83,2:51:31.960000,0:05:00.630000,93,1:52:18.284138,81,2:51:31.960000,None,0,None,0,None,2022-03-31 00:00:34,2022-04-01 00:00:34
487,ny_mlsuc,Ulster County MLS,47,14,34,46,97.87,1,2.1299999999999955,1,13,12,1,34,0,0,0,0:04:27.610000,6,0:43:14.173333,6,1:54:28.720000,0:04:27.610000,6,0:43:14.173333,6,1:54:28.720000,None,0,None,0,None,2022-03-31 00:00:34,2022-04-01 00:00:34
491,or_rmls,RMLS,937,533,419,908,96.91,29,3.0900000000000034,22,511,482,29,419,0,0,0,0:05:00.100000,231,1:19:23.533374,258,2:03:27.680000,0:05:00.100000,228,1:19:11.825436,254,2:03:27.680000,None,0,None,0,None,2022-03-31 00:00:34,2022-04-01 00:00:34
492,or_mlcobo,Central Oregon Association of Realtors MLS - COAR,169,91,87,164,97.04,5,2.9599999999999937,4,87,82,5,87,0,0,0,0:05:21.420000,47,1:43:25.080357,37,4:55:23.920000,0:20:25.250000,46,1:44:31.745244,36,4:55:23.920000,None,0,None,0,None,2022-03-31 00:00:34,2022-04-01 00:00:34
493,or_wvmls,Willamette Valley MLS,140,62,78,140,100.0,0,0.0,0,62,62,0,78,0,0,0,0:05:26.390000,39,0:57:54.077742,23,2:55:22.810000,0:05:26.390000,39,0:57:54.077742,23,2:55:22.810000,None,0,None,0,None,2022-03-31 00:00:34,2022-04-01 00:00:34
501,wa_nwmls,NWMLS,1323,1016,359,1245,94.1,78,5.900000000000006,34,982,908,74,358,1,1,0,0:16:29.020000,514,1:17:42.886945,409,4:21:29.960000,0:16:29.020000,506,1:17:10.336079,402,4:21:29.960000,1:21:37.750000,1,1:21:37.750000,0,1:21:37.750000,2022-03-31 00:00:34,2022-04-01 00:00:34
502,wa_yar,YARMLS,26,11,15,7,26.92,19,73.08,0,11,0,11,8,7,0,7,None,0,None,0,None,None,0,None,0,None,None,0,None,0,None,2022-03-31 00:00:34,2022-04-01 00:00:34
503,wa_sar,SAR MLS,149,88,65,147,98.66,2,1.3400000000000034,50,38,36,2,65,0,0,0,0:55:00.370000,10,1:15:09.670244,31,1:24:27.460000,0:55:00.370000,7,1:16:14.075833,29,1:24:27.460000,None,0,None,0,None,2022-03-31 00:00:34,2022-04-01 00:00:34
511,ut_wfrmls,WFRMLS,717,370,353,695,96.93,22,3.069999999999993,5,365,345,20,353,0,0,0,0:17:26.700000,264,0:59:58.868961,92,4:12:29.520000,0:17:26.700000,255,1:00:04.514783,90,4:12:29.520000,None,0,None,0,None,2022-03-31 00:00:34,2022-04-01 00:00:34
512,ut_pcbr,Park City MLS,19,8,11,19,100.0,0,0.0,8,0,0,0,11,0,0,0,None,0,None,0,None,None,0,None,0,None,None,0,None,0,None,2022-03-31 00:00:34,2022-04-01 00:00:34
521,co_metrolist,REcolorado MLS,1780,649,1151,1689,94.89,91,5.109999999999999,0,649,562,87,1151,0,0,0,0:15:01.430000,288,3:02:46.738559,295,6:00:00.830000,0:15:01.430000,277,3:02:57.500516,285,6:00:00.830000,None,0,None,0,None,2022-03-31 00:00:34,2022-04-01 00:00:34
522,co_ires,IRESMLS,229,125,109,206,89.96,23,10.040000000000006,0,125,104,21,98,11,11,0,0:22:26.190000,79,1:20:20.824463,42,7:02:28.470000,0:22:26.190000,58,1:14:16.692500,46,4:27:28.200000,1:02:30.910000,8,2:29:17.300000,3,7:02:28.470000,2022-03-31 00:00:34,2022-04-01 00:00:34
523,co_ppar,Peak MLS,261,157,105,250,95.79,11,4.209999999999994,2,155,144,11,105,0,0,0,0:18:23.950000,71,0:59:12.564583,73,2:23:28.330000,0:18:23.950000,71,0:59:12.564583,73,2:23:28.330000,None,0,None,0,None,2022-03-31 00:00:34,2022-04-01 00:00:34
524,co_sar,Summit AOR/MLS,20,13,7,19,95.0,1,5.0,0,13,12,1,7,0,0,0,0:44:26.500000,7,1:11:31.028333,5,1:34:24.750000,0:44:26.500000,7,1:11:31.028333,5,1:34:24.750000,None,0,None,0,None,2022-03-31 00:00:34,2022-04-01 00:00:34
525,co_par,Pueblo Association of Realtors,69,24,45,69,100.0,0,0.0,5,19,19,0,45,0,0,0,0:29:21.910000,1,0:48:24.242632,18,0:49:29.020000,0:29:21.910000,1,0:48:24.242632,18,0:49:29.020000,None,0,None,0,None,2022-03-31 00:00:34,2022-04-01 00:00:34
561,id_imls,IMLS,333,193,149,308,92.49,25,7.510000000000005,1,192,170,22,149,0,0,0,0:10:02.610000,106,1:05:46.349017,67,4:09:30.760000,0:10:02.610000,103,1:06:14.174824,67,4:09:30.760000,None,0,None,0,None,2022-03-31 00:00:34,2022-04-01 00:00:34
562,id_cdar,Coeur d Alene Association of Realtors Inc,93,48,45,93,100.0,0,0.0,33,15,15,0,45,0,0,0,0:04:59.970000,4,0:50:35.065882,13,1:08:30.960000,0:04:59.970000,4,0:50:12.191333,11,1:08:30.960000,None,0,None,0,None,2022-03-31 00:00:34,2022-04-01 00:00:34
563,id_srmls,Snake River MLS,43,26,18,39,90.7,4,9.299999999999997,4,22,19,3,18,0,0,0,1:00:00.960000,11,1:53:47.492105,8,3:23:26.450000,1:00:00.960000,11,1:53:47.492105,8,3:23:26.450000,None,0,None,0,None,2022-03-31 00:00:34,2022-04-01 00:00:34
571,tn_mtrmls,RealTracs,799,302,504,628,78.6,171,21.400000000000006,0,302,165,137,453,51,21,30,0:04:58.690000,185,1:26:43.613456,32,20:05:00.570000,0:04:58.690000,141,1:25:55.622667,24,20:05:00.570000,0:22:27.850000,18,1:48:10.464286,3,7:22:29.100000,2022-03-31 00:00:34,2022-04-01 00:00:34
572,tn_kaar,KAAR MLS,314,146,171,274,87.26,40,12.739999999999995,0,146,113,33,163,8,4,4,0:03:27.820000,77,1:27:04.555285,46,7:48:25.280000,0:03:27.820000,73,1:23:40.775487,40,7:48:25.280000,1:48:24.990000,2,1:48:25.085000,2,1:48:25.180000,2022-03-31 00:00:34,2022-04-01 00:00:34
573,tn_maar,MAAR MLS,119,68,51,119,100.0,0,0.0,45,23,23,0,51,0,0,0,0:10:00.220000,16,1:11:23.164783,7,2:05:24.510000,0:10:00.220000,16,1:11:23.164783,7,2:05:24.510000,None,0,None,0,None,2022-03-31 00:00:34,2022-04-01 00:00:34
574,tnva_mls,TVRMLS,104,46,58,100,96.15,4,3.8499999999999943,4,42,39,3,57,1,1,0,0:05:00.820000,17,1:25:26.551500,23,2:32:27.880000,0:05:00.820000,17,1:24:37.261026,22,2:32:27.880000,1:57:28.880000,1,1:57:28.880000,0,1:57:28.880000,2022-03-31 00:00:34,2022-04-01 00:00:34
575,tn_car,GCAR MLS,134,60,74,133,99.25,1,0.75,25,35,34,1,74,0,0,0,0:14:28.890000,27,0:37:52.230789,11,1:39:30.050000,0:19:25.200000,29,0:40:19.759706,5,1:39:30.050000,None,0,None,0,None,2022-03-31 00:00:34,2022-04-01 00:00:34
576,tn_rcar,River Counties MLS,49,27,22,47,95.92,2,4.079999999999998,7,20,18,2,22,0,0,0,0:55:21.640000,16,1:09:15.376316,3,3:00:01.550000,0:55:21.640000,15,1:10:01.443333,3,3:00:01.550000,None,0,None,0,None,2022-03-31 00:00:34,2022-04-01 00:00:34
611,moks_hl,Heartland MLS,434,254,185,428,98.62,6,1.3799999999999955,45,209,205,4,185,0,0,0,0:54:31.270000,50,2:17:28.203394,168,4:20:25.700000,0:54:31.270000,43,2:19:35.193024,162,4:20:25.700000,None,0,None,0,None,2022-03-31 00:00:34,2022-04-01 00:00:34
612,ks_waar,South Central Kansas MLS,90,50,40,89,98.89,1,1.1099999999999994,3,47,46,1,40,0,0,0,0:24:24.830000,27,1:00:37.790000,24,2:24:29.630000,0:24:24.830000,22,1:03:22.104348,24,2:24:29.630000,None,0,None,0,None,2022-03-31 00:00:34,2022-04-01 00:00:34
621,al_bamls,Greater Alabama MLS,305,113,193,204,66.89,101,33.11,0,113,27,86,172,21,8,13,0:13:28.560000,19,2:40:27.755526,19,8:13:26.720000,0:33:27.970000,16,2:43:38.116667,11,8:13:26.720000,3:08:25.680000,6,3:08:25.721250,2,3:08:25.790000,2022-03-31 00:00:34,2022-04-01 00:00:34
622,al_nalmls,ValleyMLS,164,69,95,121,73.78,43,26.22,0,69,33,36,95,0,0,0,0:45:03.290000,17,2:23:05.092500,19,4:40:23.920000,1:05:22.870000,14,2:29:51.769697,19,4:40:23.920000,None,0,None,0,None,2022-03-31 00:00:34,2022-04-01 00:00:34
623,al_bcar,Baldwin Realtors Alabama MLS,131,56,75,60,45.8,71,54.2,0,56,0,56,60,15,0,15,None,0,None,0,None,None,0,None,0,None,None,0,None,0,None,2022-03-31 00:00:34,2022-04-01 00:00:34
624,al_maar,Gulf Coast MLS/Mobile AOR,111,41,70,95,85.59,16,14.409999999999997,3,38,38,0,70,0,0,0,0:03:23.740000,21,0:45:37.692051,18,1:48:27.900000,0:03:24.800000,20,0:46:44.375000,18,1:48:27.900000,None,0,None,0,None,2022-03-31 00:00:34,2022-04-01 00:00:34
625,al_mlsm,Montgomery AOR Alabama MLS,75,43,33,71,94.67,4,5.329999999999998,0,43,40,3,33,0,0,0,0:20:01.790000,18,1:54:25.710000,24,2:33:26.450000,0:20:01.790000,17,1:53:58.618500,23,2:33:26.450000,None,0,None,0,None,2022-03-31 00:00:34,2022-04-01 00:00:34
651,mn_rmls,Northstar MLS,1318,396,936,1108,84.07,210,15.930000000000007,2,394,228,166,847,89,51,38,0:55:01.020000,252,1:28:57.031200,48,8:22:23.930000,0:55:01.020000,187,1:27:19.141447,41,8:22:23.930000,1:17:25.920000,48,1:30:42.443333,3,5:22:30.710000,2022-03-31 00:00:34,2022-04-01 00:00:34
662,wi_scwmls,SCWMLS,219,90,130,202,92.24,17,7.760000000000005,0,90,74,16,130,0,0,0,0:50:22.440000,45,1:59:43.323108,29,4:05:33.120000,0:50:22.440000,45,1:59:43.323108,29,4:05:33.120000,None,0,None,0,None,2022-03-31 00:00:34,2022-04-01 00:00:34
663,wi_gmar,METROMLS,242,174,70,228,94.21,14,5.790000000000006,1,173,159,14,70,0,0,0,0:15:01.590000,68,1:46:07.439573,96,2:21:32.860000,0:15:01.590000,67,1:45:55.427296,92,2:21:32.860000,None,0,None,0,None,2022-03-31 00:00:34,2022-04-01 00:00:34
664,wi_ranw,RANW MLS,176,72,105,176,100.0,0,0.0,27,45,45,0,105,0,0,0,1:00:00.560000,33,1:31:14.041304,13,2:16:32.980000,1:00:00.560000,32,1:31:27.032000,13,2:16:32.980000,None,0,None,0,None,2022-03-31 00:00:34,2022-04-01 00:00:34
691,mo_maris,MARIS,583,224,363,501,85.93,82,14.069999999999993,48,176,109,67,343,20,7,13,0:59:57.650000,73,3:03:36.860076,58,9:15:03.990000,0:59:57.650000,61,3:02:42.718716,48,7:00:02.730000,1:15:01.520000,4,4:32:11.702857,3,9:15:03.990000,2022-03-31 00:00:34,2022-04-01 00:00:34
692,mo_tlbor,SOMO MLS,164,66,98,34,20.73,130,79.27,0,66,0,66,58,40,0,40,None,0,None,0,None,None,0,None,0,None,None,0,None,0,None,2022-03-31 00:00:34,2022-04-01 00:00:34
693,mo_lobr,Bagnell Dam AOR,52,23,30,51,98.08,1,1.9200000000000017,2,21,21,0,30,0,0,0,0:09:37.900000,12,1:42:39.724545,10,6:50:23.680000,0:09:37.900000,14,1:46:07.175714,7,6:50:23.680000,None,0,None,0,None,2022-03-31 00:00:34,2022-04-01 00:00:34
694,mo_tlbor,Tri Lake Board of Realtors,162,82,81,16,9.88,146,90.12,0,82,0,82,48,33,0,33,None,0,None,0,None,None,0,None,0,None,None,0,None,0,None,2022-03-31 00:00:34,2022-04-01 00:00:34
721,la_gsrein,GSREIN,378,126,252,372,98.41,6,1.5900000000000034,0,126,120,6,252,0,0,0,0:15:00.730000,80,1:38:10.367266,48,3:06:27.420000,0:15:00.730000,74,1:38:20.359167,46,3:06:27.380000,None,0,None,0,None,2022-03-31 00:00:34,2022-04-01 00:00:34
722,la_gbrmls,Greater Baton Rouge AOR,134,67,67,131,97.76,3,2.239999999999995,1,66,64,2,67,0,0,0,0:05:01.030000,35,1:30:35.873816,41,2:18:29.100000,0:30:01.590000,30,1:33:49.116250,34,2:18:29.100000,None,0,None,0,None,2022-03-31 00:00:34,2022-04-01 00:00:34
741,ok_okc,MLSOK,320,141,192,301,94.06,19,5.939999999999998,3,138,120,18,192,0,0,0,0:05:22.820000,67,1:37:40.125231,63,7:55:25.600000,0:15:00.950000,63,1:40:38.895917,57,7:55:25.600000,None,0,None,0,None,2022-03-31 00:00:34,2022-04-01 00:00:34
801,nd_fmaar,FMAAR,111,29,82,110,99.1,1,0.9000000000000057,6,23,22,1,82,0,0,0,0:04:37.650000,12,1:28:12.647826,11,3:35:25.540000,0:04:37.650000,11,1:30:36.722727,11,3:35:25.540000,None,0,None,0,None,2022-03-31 00:00:34,2022-04-01 00:00:34
811,sc_ccar,CCLMS,153,57,97,148,96.73,5,3.269999999999996,0,57,54,3,97,0,0,0,0:22:25.380000,24,0:56:38.589153,35,2:22:29.410000,0:22:25.380000,41,0:58:02.830556,13,2:22:29.410000,None,0,None,0,None,2022-03-31 00:00:34,2022-04-01 00:00:34
812,sc_ctar,Charleston Trident MLS,196,124,77,192,97.96,4,2.0400000000000063,3,121,118,3,77,0,0,0,0:17:27.090000,61,0:53:31.570000,63,1:32:28.020000,0:17:27.090000,56,0:54:12.975254,62,1:32:28.020000,None,0,None,0,None,2022-03-31 00:00:34,2022-04-01 00:00:34
813,sc_smls,SPTBGMLS,74,39,36,74,100.0,0,0.0,26,13,13,0,36,0,0,0,0:11:26.060000,6,0:41:21.289231,7,1:11:30.300000,0:11:26.060000,6,0:41:21.289231,7,1:11:30.300000,None,0,None,0,None,2022-03-31 00:00:34,2022-04-01 00:00:34
814,sc_cml,CMLS,180,82,101,158,87.78,22,12.219999999999999,0,82,60,22,101,0,0,0,0:30:00.760000,30,2:10:38.473000,30,4:20:26.520000,0:30:00.760000,30,2:10:38.473000,30,4:20:26.520000,None,0,None,0,None,2022-03-31 00:00:34,2022-04-01 00:00:34
815,sc_ggar,GGAR,199,103,97,189,94.97,10,5.030000000000001,25,78,68,10,97,0,0,0,0:22:25.380000,49,1:03:08.905652,20,2:57:26.080000,0:22:25.380000,48,1:03:35.998529,20,2:57:26.080000,None,0,None,0,None,2022-03-31 00:00:34,2022-04-01 00:00:34
816,sc_aar,Western Upstate AOR,79,40,39,78,98.73,1,1.269999999999996,0,40,40,0,39,0,0,0,0:37:24.210000,25,1:13:16.470000,16,1:37:27.940000,0:37:24.210000,24,1:13:25.208250,16,1:37:27.940000,None,0,None,0,None,2022-03-31 00:00:34,2022-04-01 00:00:34
821,ri_statewide,State-Wide MLS,115,68,52,106,92.17,9,7.829999999999998,0,68,64,4,52,0,0,0,0:30:01.130000,44,1:56:51.598824,24,3:31:26.960000,0:51:26.310000,40,2:00:06.594063,24,3:31:26.960000,None,0,None,0,None,2022-03-31 00:00:34,2022-04-01 00:00:34
831,oh_neohrex,YesMLS,560,320,241,545,97.32,15,2.680000000000007,4,316,304,12,241,0,0,0,0:07:26.450000,179,1:21:32.936677,134,5:07:23.330000,0:07:26.450000,177,1:20:41.933947,127,5:07:23.330000,None,0,None,0,None,2022-03-31 00:00:34,2022-04-01 00:00:34
832,oh_wrist,WRIST,40,21,19,36,90.0,4,10.0,0,21,17,4,19,0,0,0,0:05:00.860000,12,1:30:54.281667,6,3:53:21.480000,0:05:00.860000,11,1:31:03.135882,6,3:53:21.480000,None,0,None,0,None,2022-03-31 00:00:34,2022-04-01 00:00:34
833,oh_dabr,DABR MLS,130,80,59,130,100.0,0,0.0,0,80,80,0,59,0,0,0,0:25:01.530000,38,1:21:09.930706,47,1:51:32.020000,0:25:01.530000,40,1:21:40.937375,40,1:51:32.020000,None,0,None,0,None,2022-03-31 00:00:34,2022-04-01 00:00:34
834,oh_cincy,CincyMLS,107,56,51,96,89.72,11,10.280000000000001,47,9,3,6,47,4,0,4,0:38:23.160000,2,0:46:43.516667,1,1:03:23.370000,0:38:23.160000,2,0:46:43.516667,1,1:03:23.370000,None,0,None,0,None,2022-03-31 00:00:34,2022-04-01 00:00:34
835,oh_cbr,CCOR MLS,327,155,175,239,73.09,88,26.909999999999997,1,154,79,75,149,26,13,13,0:05:00.630000,50,0:58:13.237263,45,5:23:24.850000,0:18:25.870000,48,0:55:49.054557,31,5:23:24.850000,0:43:28.510000,1,1:15:43.733846,12,1:18:25.460000,2022-03-31 00:00:34,2022-04-01 00:00:34
836,oh_tbr,NORIS,93,27,66,93,100.0,0,0.0,1,26,26,0,66,0,0,0,0:05:00.640000,12,0:58:16.128148,15,1:59:28.400000,0:05:00.640000,11,0:58:23.633462,15,1:59:28.400000,None,0,None,0,None,2022-03-31 00:00:34,2022-04-01 00:00:34
841,mi_realcomp,Realcomp,1464,551,925,1314,89.75,150,10.25,21,530,389,141,909,16,12,4,0:24:58.930000,289,1:12:05.617866,128,16:55:02.320000,0:24:58.930000,276,1:11:52.097429,113,16:55:02.320000,1:23:25.390000,10,1:40:06.027500,2,4:13:29.200000,2022-03-31 00:00:34,2022-04-01 00:00:34
842,mi_nglrmls,NGLRMLS,151,38,114,151,100.0,0,0.0,3,35,35,0,114,0,0,0,0:10:23.320000,24,1:13:27.084167,12,3:10:28.020000,0:15:02.310000,23,1:15:15.191714,12,3:10:28.020000,None,0,None,0,None,2022-03-31 00:00:34,2022-04-01 00:00:34
843,mi_swmric,MichRIC,342,204,139,330,96.49,12,3.510000000000005,7,197,187,10,139,0,0,0,0:20:00.620000,114,1:54:47.853538,81,4:40:29.470000,0:20:00.620000,110,1:54:12.569840,77,4:40:29.470000,None,0,None,0,None,2022-03-31 00:00:34,2022-04-01 00:00:34
844,mi_realsource,ECAR MLA,27,11,18,27,100.0,0,0.0,0,11,11,0,18,0,0,0,0:05:26.950000,5,2:22:31.280000,6,5:30:00.530000,0:05:26.950000,5,2:22:31.280000,6,5:30:00.530000,None,0,None,0,None,2022-03-31 00:00:34,2022-04-01 00:00:34
845,mi_wwbr,Water Wonderlandd,35,16,19,35,100.0,0,0.0,9,7,7,0,19,0,0,0,0:57:25.400000,4,1:18:50.465714,3,2:22:24.770000,0:57:25.400000,4,1:18:50.465714,3,2:22:24.770000,None,0,None,0,None,2022-03-31 00:00:34,2022-04-01 00:00:34
846,mi_glar,Greater Lansing AOR,38,24,17,31,81.58,7,18.42,0,24,17,7,14,3,3,0,0:55:03.030000,11,1:37:47.536000,9,2:57:22.640000,0:55:03.030000,9,1:30:48.058824,8,2:57:22.640000,2:17:24.570000,2,2:17:24.573333,1,2:17:24.580000,2022-03-31 00:00:34,2022-04-01 00:00:34
851,in_mibor,MIBOR MLS,329,213,118,321,97.57,8,2.430000000000007,6,207,199,8,118,0,0,0,0:18:23.320000,168,0:41:35.243571,42,1:38:26.640000,0:18:23.320000,161,0:41:12.077136,38,1:38:26.640000,None,0,None,0,None,2022-03-31 00:00:34,2022-04-01 00:00:34
852,in_lbar,IRMLS,337,153,191,321,95.25,16,4.75,3,150,139,11,191,0,0,0,0:25:25.490000,101,1:22:16.326846,48,4:05:23.100000,0:25:25.490000,95,1:21:51.045899,44,4:05:23.100000,None,0,None,0,None,2022-03-31 00:00:34,2022-04-01 00:00:34
853,in_gniar,GNIAR,148,51,99,130,87.84,18,12.159999999999997,1,50,32,18,99,0,0,0,0:45:01.420000,13,1:30:25.162121,20,2:20:24.570000,0:45:01.420000,12,1:30:26.018750,20,2:20:24.570000,None,0,None,0,None,2022-03-31 00:00:34,2022-04-01 00:00:34
861,ky_msmls,GLAR MLS,154,81,74,105,68.18,49,31.819999999999993,9,72,24,48,74,0,0,0,1:00:02.040000,15,2:42:37.810000,10,7:25:22.230000,1:00:02.040000,15,2:30:50.959167,9,5:55:25.740000,None,0,None,0,None,2022-03-31 00:00:34,2022-04-01 00:00:34
862,ky_lbar,LBAR MLS,169,73,98,165,97.63,4,2.3700000000000045,0,73,71,2,98,0,0,0,0:29:27.370000,33,1:16:44.606081,41,2:24:29.070000,0:44:21.450000,31,1:17:36.860282,40,2:24:29.070000,None,0,None,0,None,2022-03-31 00:00:34,2022-04-01 00:00:34
863,ky_nkmls,Northern Kentucky AOR,104,40,65,93,89.42,11,10.579999999999998,0,40,30,10,65,0,0,0,1:08:26.370000,17,1:46:51.814194,14,4:18:24.730000,1:08:26.370000,16,1:47:08.655667,14,4:18:24.730000,None,0,None,0,None,2022-03-31 00:00:34,2022-04-01 00:00:34
871,hi_hbr,HiCentral,134,49,89,128,95.52,6,4.480000000000004,2,47,41,6,89,0,0,0,0:05:00.200000,25,1:11:40.231463,16,4:56:26.870000,0:05:00.200000,25,1:11:40.231463,16,4:56:26.870000,None,0,None,0,None,2022-03-31 00:00:34,2022-04-01 00:00:34
872,hi_ram,RAM,31,16,19,29,93.55,2,6.450000000000003,0,16,14,2,19,0,0,0,0:16:27.110000,9,0:43:28.950000,5,1:11:27.420000,0:16:27.110000,9,0:43:28.950000,5,1:11:27.420000,None,0,None,0,None,2022-03-31 00:00:34,2022-04-01 00:00:34
881,wv_ncwv,NCWVREIN,57,16,41,55,96.49,2,3.510000000000005,2,14,14,0,41,0,0,0,0:28:25.670000,8,0:55:57.620667,7,1:23:25.940000,0:28:25.670000,8,0:53:59.883571,6,1:18:25.080000,None,0,None,0,None,2022-03-31 00:00:34,2022-04-01 00:00:34
890,nh_nneren,NEREN,362,180,184,358,98.9,4,1.0999999999999943,0,180,176,4,184,0,0,0,0:10:00.100000,106,1:05:17.176836,71,2:21:32.580000,0:10:00.100000,105,1:05:20.196136,71,2:21:32.580000,None,0,None,0,None,2022-03-31 00:00:34,2022-04-01 00:00:34
900,ne_oabr,GPR MLS,201,127,74,201,100.0,0,0.0,0,127,127,0,73,1,1,0,0:05:01.510000,67,1:32:02.852681,71,2:12:27.980000,0:05:01.510000,64,1:33:09.267480,63,2:12:27.980000,1:12:28.890000,1,1:12:28.890000,0,1:12:28.890000,2022-03-31 00:00:34,2022-04-01 00:00:34
910,ak_amls,Alaska MLS,65,35,30,56,86.15,9,13.849999999999994,0,35,27,8,30,0,0,0,1:35:20.690000,15,2:37:14.700000,14,3:20:23.220000,1:35:20.690000,13,2:40:20.798519,14,3:20:23.220000,None,0,None,0,None,2022-03-31 00:00:34,2022-04-01 00:00:34
920,ar_carmls,CAR MLS,216,79,142,210,97.22,6,2.780000000000001,1,78,72,6,142,0,0,0,0:04:38.750000,47,1:36:08.442162,27,6:05:21.210000,0:04:38.750000,45,1:36:26.310972,27,6:05:21.210000,None,0,None,0,None,2022-03-31 00:00:34,2022-04-01 00:00:34
921,ar_nwar,NWABOR,1162,69,1098,1160,99.83,2,0.1700000000000017,11,58,57,1,1098,0,0,0,0:04:38.160000,36,1:27:02.689672,25,3:05:24.160000,0:04:38.160000,32,1:28:33.958070,25,3:05:24.160000,None,0,None,0,None,2022-03-31 00:00:34,2022-04-01 00:00:34
930,ct_gnhar,Connecticut MLS,666,255,418,570,85.59,96,14.409999999999997,7,248,174,74,385,33,13,20,0:04:59.800000,135,0:54:31.682222,54,6:40:25.250000,0:04:59.800000,113,0:45:34.649483,61,6:40:25.250000,2:25:20.770000,10,2:51:08.955385,3,5:40:24.580000,2022-03-31 00:00:34,2022-04-01 00:00:34
940,ia_dmaar,DMAAR,181,82,99,176,97.24,5,2.760000000000005,0,82,79,3,99,0,0,0,0:55:02.470000,42,4:03:35.575783,41,8:05:26.140000,0:55:02.470000,41,3:58:26.180253,38,8:05:26.140000,None,0,None,0,None,2022-03-31 00:00:34,2022-04-01 00:00:34
941,ia_craar,Cedar Rapids MLS,59,32,28,42,71.19,17,28.810000000000002,0,32,22,10,27,1,0,1,0:20:00.800000,10,1:06:33.375909,12,1:39:39.300000,0:20:00.800000,10,1:06:33.375909,12,1:39:39.300000,None,0,None,0,None,2022-03-31 00:00:34,2022-04-01 00:00:34
942,ia_swiar,Southwest Iowa AOR,14,10,4,10,71.43,4,28.569999999999993,0,10,6,4,4,0,0,0,0:29:58.930000,6,1:46:04.979000,4,3:29:57.990000,0:39:40.590000,3,1:53:21.171667,3,3:04:40.530000,None,0,None,0,None,2022-03-31 00:00:34,2022-04-01 00:00:34
950,me_mreis,MREIS,267,107,161,70,26.22,197,73.78,0,107,0,107,121,40,0,40,None,0,None,0,None,None,0,None,0,None,None,0,None,0,None,2022-03-31 00:00:34,2022-04-01 00:00:34
961,ms_mgcmls,MGC MLS,0,0,0,0,0,0,0,0,0,0,0,0,0,0,0,None,0,None,0,None,None,0,None,0,None,None,0,None,0,None,2022-03-31 00:00:34,2022-04-01 00:00:34
962,ms_mlsoj,CMMLS,185,113,74,-78,-42.16,263,142.16,0,113,0,113,27,47,0,47,None,0,None,0,None,None,0,None,0,None,None,0,None,0,None,2022-03-31 00:00:34,2022-04-01 00:00:34
970,mt_nmar,Missoula MLS,112,33,79,110,98.21,2,1.7900000000000063,6,27,27,0,79,0,0,0,0:05:00.240000,15,0:48:38.720000,13,1:44:26.790000,0:05:00.240000,15,0:49:54.776296,12,1:44:26.790000,None,0,None,0,None,2022-03-31 00:00:34,2022-04-01 00:00:34
971,mt_bzm,Big Sky Country MLS,51,19,32,50,98.04,1,1.9599999999999937,0,19,18,1,32,0,0,0,1:09:26.240000,12,1:50:01.205000,8,2:29:28.240000,1:19:26.740000,10,1:52:51.773889,8,2:29:28.240000,None,0,None,0,None,2022-03-31 00:00:34,2022-04-01 00:00:34
972,mt_bar,Billings MLS,48,33,16,48,100.0,0,0.0,0,33,33,0,16,0,0,0,0:30:01.310000,16,1:25:08.510882,18,1:55:01.460000,0:30:01.310000,15,1:26:48.607576,18,1:55:01.460000,None,0,None,0,None,2022-03-31 00:00:34,2022-04-01 00:00:34
980,sd_bhmls,Black Hills MLS,23,13,11,20,86.96,3,13.040000000000006,1,12,9,3,11,0,0,0,0:35:23.320000,4,2:12:44.983000,6,3:55:23.780000,0:35:23.320000,4,2:01:54.043333,5,3:55:23.780000,None,0,None,0,None,2022-03-31 00:00:34,2022-04-01 00:00:34
992,nm_swmls,SWMLS,158,72,86,157,99.37,1,0.6299999999999955,1,71,70,1,86,0,0,0,0:10:01.410000,37,1:57:15.518267,38,3:46:27.790000,0:10:01.410000,35,1:53:18.945714,35,3:46:27.790000,None,0,None,0,None,2022-03-31 00:00:34,2022-04-01 00:00:34
993,wy_wymls,Wyoming MLS,68,19,49,68,100.0,0,0.0,0,19,19,0,49,0,0,0,0:39:27.920000,10,2:19:26.574737,9,4:19:27.100000,0:39:27.920000,10,2:19:26.574737,9,4:19:27.100000,None,0,None,0,None,2022-03-31 00:00:34,2022-04-01 00:00:34
994,nm_sfar,Santa Fe AOR MLS,24,8,16,24,100.0,0,0.0,0,8,8,0,16,0,0,0,0:41:25.840000,4,1:15:43.972222,5,1:31:27.740000,1:00:02.120000,3,1:20:01.238750,5,1:31:27.740000,None,0,None,0,None,2022-03-31 00:00:34,2022-04-01 00:00:34
999,va_wmls,Williamsburg MLS,26,12,14,26,100.0,0,0.0,0,12,12,0,14,0,0,0,0:30:01.770000,4,1:02:00.809167,8,1:38:26.090000,0:30:01.770000,4,1:02:00.809167,8,1:38:26.090000,None,0,None,0,None,2022-03-31 00:00:34,2022-04-01 00:00:34
